xxxxxxxxxxexxxxxxxxxx
x       g    xx     x
x   xxxx g   xx h g x
x xxxxxx xxxxccgg   x
x ccg x  xxxxxx     x
x                   x
xxxxxxx   xxxxxxxxxxx
x  q      x  xx     x
x xxx   xxx      x  x
x   xxx      qx     x
xxxxxxxxxxxxxxxxxx  x
x      x    g    x  x
x      x      xh x  x
xs        r   x    cx
xxxxxxxxxxxxxxxxxxxxx
#+################=##