XXXXXXXXXXXXXXXX
X      h       X
X  *  ccccc    X
X              X
X  m mmmmmm   BE
X              X
X              X
XS    q        X
XXXXXXXXXXXXXXXX