12
XXXXXXXXXXXXXXXXXXXXXXXXX
XS           n          X
X  a  hh qq         RR  X
XXXXXXXXXXXXXXXXXXXXXR  X
X                       X
X                       X
X                       X
X     Z     Z     Z     X
X                       X
X                       X
E                       X
XXXXXXXXXXXXXXXXXXXXXXXXX
H#I######N############C#Q