11
XXXXXXXXXXXXXXXXXX
X    G G   G     X
X     X   X G    X
X     X   X  G   X
XE    X   X   G  X
XXXXXXX   X      X
X         X      X
X  XXXX   X    qqX
X     X   XXXXXXXX
X     X          X
XhhcccX G       SX
XXXXXXXXXXXXXXXXXX
H#I######N#####C#Q