XXXXXXXXXXXXXXXXXX
X  GG         G hX
X                X
X      XXXXXXX   X
X      X     G   X
X      X         X
X      XS  q     X
X    c XXXXXXXXXXX
Xn        G      X
X               cX
X     G          E
XXXXXXXXXXXXXXXXXX