1
XXXXXXXXXXXXXXXX
X      h       X
X     c        X
X              X
X  n      G    E
X              X
X              X
XS    q        X
XXXXXXXXXXXXXXXX
H#I####N#####C#Q