XXXXXXXXXXXXXXXX
XXn q   h      E
XXXcGXGXGXGXXXXX
XTXcccc     XXXX
XSXXXXXXXXX XXXX
X XXXXXXXXX XXXX
X XXXGXGXGX XXXX
X             hX
XXXXXXXXXXXXXXXX