xxxxxxxxxxxxxxxxxxxxx
x         stx       x
x      xxxxxx   h g x
x      x     c gg   x
x ccg  xx   x       x
x      x    x       x
x      x  xxxxxxx xxx
x  q  rx  x         x
x      x  x  r      e
x      x  x  qx  x  x
x  g   x  x         x
x    q x  x g  r §  x
x      x  x   x  xxxx
xn        x r x  ghcx
xxxxxxxxxxxxxxxxxxxxx
#+#######%########=##