2
XXXXXXXXXXXXXXXX
XXn q   h      E
XXXcGXGXGXGXXXXX
XXXcccc     XXXX
XSXXXXXXXXX XXXX
X XXXXXXXXX XXXX
X XXXGXGXGX XXXX
X             hX
XXXXXXXXXXXXXXXX
H#I######N###C#Q