xxxxxxxxxxxxxxxxxxxxx
x       g           x
x      x g  x   h g x
x      x    xc gg   x
x ccg  xxxxxx       x
x      x            x
x      x  xxxxxxxxxxx
x  q   x  x         x
x      x  x         e
x      x  x  qx  x  x
x      x  x         x
x      x  x g       x
x      x  x   x  xxxx
xs     x      x  ghcx
xxxxxxxxxxxxxxxxxxxxx
#+#######%########=##