3
XXXXXXXXXXXXXXXX
XSX   c G     aX
X X    G G     X
X X  G   h     X
X X G  hG  Gn  E
X X  G      q  X
X X   G  G     X
X      G       X
XXXXXXXXXXXXXXXX
H#I######N###C#Q