3
xxxxxxxxxxxxxxxx
xsx   c g      x
x x    g g     x
x x  g    h    x
x x g  hg  gn  e
x x  g      q  x
x x   g  g     x
x      g       x
xxxxxxxxxxxxxxxx
#+#%#########=##