xxxxxxxxxxxxxxxxxxxxx
x                   x
x      x g  x   h g x
x      x    xc gg   x
x ccg  x  xxxxxxxxxxx
x      x  x         e
xxx xxxx  x  x   x  x
x  q   x  x         x
x      x  x         x
x      x  x  x § x  x
x      x  x         x
x      x  x  x   x  x
x      x  x         x
xts    x    g   h   x
xxxxxxxxxxxxxxxxxxxxx
#+#######%########=##