xxxxxxxxxxxxxxxxxxxxx
x      x            x
x      x g  x   h g x
x      x    xc gg   x
x ccg  x  xxxxxxxxxxx
x      x  x         x
xxxxxxxx  x  x   x  x
x  q   x  x         x
x      x  x         x
x      x  x  x   x  x
x      x  x         x
x      x  x gx   x  x
x      x  x         x
xs     x  x         x
xxxxxxxxxxxxxxxxxxxxx
#+#######%########=##