4
xxxxxxxxxxxxxxxx
x     h        x
x              x
x    c         x
x       z   n  e
x    q         x
x              x
xs             x
xxxxxxxxxxxxxxxx
#+#%#########=##