4
XXXXXXXXXXXXXXXX
X     h        X
X              X
X    c         X
X        Z  n  E
X    q         X
X              X
XS             X
XXXXXXXXXXXXXXXX
H#I######N###C#Q