XXXXXXXXXXXXXXXX
X c     q      X
X    X         X
X    X    h    X
X  G Xs       SX
X    XXXXXXXXXXX
X       G    G X
X n   E   G    X
XXXXXXXXXXXXXXXX