6
XXXXXXXXXXXXXXXXXXXX
X n      G         X
X  G X             X
X   GXXXXXXR  XXXXXX
X  XXX  G     X h qX
X    X       XG    X
X   cX    XXX      X
X   hX             X
XS   X    G    G   E
XXXXXXXXXXXXXXXXXXXX
H#I######N#######C#Q