7
XXXXXXXXXXXXXXXXXXXXXXXXXX
XG     G   X        G    X
X   X      X   XXXXX     X
X   X   G hXn     GX  q  X
X   X   XXXXXXXX   X     X
E ahXc             X    SX
XXXXXXXXXXXXXXXXXXXXXXXXXX
H#I######N#############C#Q