XXXXXXXXXXXXXXXXXXXXX
E      c  q q  h h  X
XXXXXXXXXXXXXXXXXX  X
X                   X
X                   X
X    Z       Z      X
X                   X
X                   X
XXXXXXXXXXXX        X
X n    X            X
XS  X    h q        X
XXXXXXXXXXXXXXXXXXXXX