XXXXXXXXXXXXXXXXXXXXXXX
XS     n       G     qX
X                     X
XXXXXXXXXXXXXXXXXXX   X
X       G       hqX   X
X   G       G     X   X
X   XXXXXXXXXXX   X   X
X   XG       EX   X   X
X   X  XXXXXXXX   X   X
X   X G          hX   X
X   XXXXXXXXXXXXXXX   X
X            s        X
Xh      G     cc   G  X
XXXXXXXXXXXXXXXXXXXXXXX